[0;1;32;42m¾[1mð[0m,ªL,[0;1;36;44m¡[1mË[0m,[0;1;36;44m¢[1mf[0m,[0;1;37;47mÃ[1mú[0m
´ËªL1,´ËªL2,«æ¬y,²LÅy,Á¡Ãú 
02,02,02,02,02,02,02,03,03,00,00,00,00,00,04
02,02,02,02,02,02,02,02,03,03,00,00,00,04,00
03,03,03,03,02,02,02,02,02,03,00,00,04,00,00
01,01,01,03,03,02,02,02,02,03,03,04,00,00,00
00,00,00,01,03,03,02,02,02,02,03,03,03,03,03
00,00,00,00,01,03,03,02,02,02,02,02,02,02,02
00,01,01,01,00,01,03,03,02,02,02,02,02,02,02
00,01,01,01,00,00,01,01,03,03,02,02,02,02,02
00,00,00,04,00,00,00,04,01,03,03,03,03,03,03
04,01,04,01,04,01,04,01,04,04,04,04,04,04,04
00,04,00,00,00,04,00,00,00,00,00,04,01,01,04
00,01,01,01,00,01,01,01,00,00,00,04,01,01,04
00,01,01,01,00,01,01,01,00,00,00,04,01,01,04
00,01,01,01,00,01,01,01,00,00,00,04,04,04,04

