  ,║,╗,╔,╝,╚,═,護,堂,主,房,舵,主,房,｜,╱,╲,－
牆,牆,牆,牆,牆,牆,牆,長老護法房,堂主房,堂主房,堂主房,舵主房,舵主房,舵主房,道路,道路,道路,道路
03,06,06,06,06,06,06,06,06,06,06,06,02
01,00,00,00,00,00,00,00,00,00,00,00,01
01,00,00,00,00,11,12,13,00,00,00,00,01
01,00,00,00,00,00,14,00,00,00,00,00,01
01,00,00,00,08,17,09,17,10,00,00,00,01
01,00,00,00,00,00,14,00,00,00,00,00,01
01,00,00,00,00,00,07,00,00,00,00,00,01
01,00,00,00,00,15,00,16,00,00,00,00,01
01,00,00,00,07,00,00,00,07,00,00,00,01
01,00,00,15,00,00,00,00,00,16,00,00,01
01,00,07,00,00,00,00,00,00,00,07,00,01
01,00,00,00,00,00,00,00,00,00,00,00,01
05,06,06,06,06,06,06,06,06,06,06,06,04
