¢®,[1;36m¢Ï[2;37;0m,[46;1m¡@[2;37;0m,[46;1;33m¡¸[2;37;0m
«D¾Ô°Ï,°Ï°ì¢Ï³òÀð,´ËªL,¶Ç°eÂI
01,01,01,01,01,01,01,01,01,01,01,01,01,01,01,01
01,03,02,02,00,02,02,00,02,02,02,02,00,02,00,01
01,02,00,02,00,02,00,02,02,00,00,02,02,02,00,01
01,02,00,02,00,02,00,02,00,00,00,02,00,02,00,01
01,02,02,02,02,02,02,02,00,00,00,02,02,02,00,01
01,02,00,00,00,00,02,00,00,00,00,00,00,02,00,01
01,02,00,02,02,02,02,00,00,00,02,02,02,02,00,01
01,02,02,00,00,00,00,00,00,02,02,00,00,02,03,01
01,00,02,02,02,02,02,02,02,02,00,02,02,02,00,01
01,01,01,01,01,01,01,01,01,01,01,01,01,01,01,01
