[34m¢i[0m,[33m¡¶[0m,[0;1;34m¢[1mi[0m,[0;1;37m¡[1mE[0m,[0;1;32m¢[1mi[0m
´ò,¤s,´ò¤¤,¸H¥Û¸ô,¯ó¦a
01,01,01,01,01,01,01,01,01,01
01,04,04,04,03,03,03,03,01,01
01,04,02,02,02,00,00,03,03,01
01,04,04,00,00,00,00,00,03,01
01,04,03,00,00,00,00,03,03,01
01,03,03,03,00,00,00,00,03,01
01,01,03,03,03,03,00,03,03,01
01,04,04,04,04,03,04,03,04,01
01,01,01,04,04,04,04,03,01,01
01,01,01,01,01,01,01,03,01,01
