[30;44m~~[0m,[33m¡¶[0m,¢i,Âí,[0;1;36;46mù[1má[0m,[36;44m::[0m,[0;1;30m¡[1m¼[0m,  ,[32mªL[0m,[46m¡k[0m
¤j®ü,°ª¤s,¥Û¾À,«°Âí,©¥¼ß,¸®«Í¦¿,¥ÛªO¸ô,¯ó­ì,º_¾ðªL,«ý¾ô
00,00,00,00,00,00,00,00,00,00,00,00,00,00,00,00,00,00,00
00,00,00,00,07,07,00,00,00,07,07,00,00,00,07,07,00,00,00
00,03,06,06,07,08,07,07,07,07,07,07,07,07,06,06,07,00,00
00,00,07,06,08,08,01,01,07,07,07,06,06,06,06,03,07,07,00
00,00,00,06,08,08,08,01,05,05,05,06,07,07,06,07,07,07,00
00,00,07,06,01,01,01,08,07,07,05,09,05,05,06,07,07,07,00
00,07,07,06,01,01,08,07,07,07,07,06,07,05,06,07,07,07,00
00,00,07,06,01,07,07,07,07,03,07,06,07,05,09,05,05,00,00
00,00,07,06,07,07,07,07,07,06,06,06,06,06,06,08,00,00,00
00,00,07,06,06,06,06,06,06,06,07,07,08,08,08,08,00,00,00
00,07,07,07,07,07,07,07,07,07,07,07,07,07,08,08,08,07,00
00,07,03,07,07,00,07,07,07,07,07,07,07,07,07,08,07,07,00
00,07,07,07,00,00,00,07,07,07,07,07,00,00,07,07,07,00,00
00,00,00,00,00,00,00,00,00,00,00,00,00,00,00,00,00,00,00

