
¡½¡½¡½¡½¡½¡½¡½¡½¡½¡½¡D¡½¡½¡½¡½¡½¡½¡½¡½¡½¡½
¡½¡½¡½¡½¡½¡½¡½¡½¡½¡½¡D¡½¡½¡½¡½¡½¡½¡½¡½¡½¡½
¡½¡½¡½¡½¡½¡D¡D¡D¡D¡D¡D¡D¡D¡D¡D¡D¡½¡½¡½¡½¡½
¡½¡½¡½¡½¡½¡D¡½¡½¡½¡½¡D¡½¡½¡½¡½¡D¡½¡½¡½¡½¡½
¡½¡½¡½¡½¡½¡D¡½¡½¡½¡½¡D¡½¡½¡½¡½¡D¡½¡½¡½¡½¡½
¡½¡½¡½¡½¡½¡D¡½¡½¡½¡½¡D¡½¡½¡½¡½¡D¡½¡½¡½¡½¡½
¡½¡½¡½¡½¡½¡D¡½¡½¡½¡½¡D¡½¡½¡½¡½¡D¡½¡½¡½¡½¡½
¡½¡½¡½¡½¡½¡D¡½¡½¡½¡½¡D¡½¡½¡½¡½¡D¡½¡½¡½¡½¡½
¡½¡½¡½¡½¡½¡D¡½¡½¡½¡½¡D¡½¡½¡½¡½¡D¡½¡½¡½¡½¡½
¡½¡½¡½¡½¡½¡D¡½¡½¡½¡½¡D¡½¡½¡½¡½¡D¡½¡½¡½¡½¡½
¡½¡½¡½¡½¡½¡D¡½¡½¡½¡½¡D¡½¡½¡½¡½¡D¡½¡½¡½¡½¡½
¡½¡½¡½¡½¡½¡D¡D¡D¡D¡D¡D¡D¡D¡D¡D¡D¡½¡½¡½¡½¡½
¡½¡½¡½¡½¡½¡½¡½¡½¡½¡½¡D¡½¡½¡½¡½¡½¡½¡½¡½¡½¡½
¡½¡½¡½¡½¡½¡½¡½¡½¡½¡½¡D¡½¡½¡½¡½¡½¡½¡½¡½¡½¡½



