[1;34;44m¢i[0m,ùø,ùß,,ùå,ùã,ùù,¡@,¡@,¡@,[1;32;44m¡U[0m,[1;32;44m¢¬[0m,[1;32;44m¢­[0m,[1;32;44m¡Ð[0m
Àð,Àð,Àð,Àð,Àð,Àð,Àð,ªø¦ÑÅ@ªk©Ð,°ó¥D©Ð,²ë¥D©Ð,¹D¸ô,¹D¸ô,¹D¸ô,¹D¸ô,
03,06,06,06,06,06,06,06,06,06,02,
01,00,00,00,00,00,00,00,00,00,01,
01,00,00,00,09,09,09,00,00,00,01,
01,00,00,00,00,10,00,00,00,00,01,
01,00,00,08,08,08,08,08,00,00,01,
01,00,00,00,00,10,00,00,00,00,01,
01,00,00,00,00,07,00,00,00,00,01,
01,00,00,00,11,00,12,00,00,00,01,
01,00,00,07,00,00,00,07,00,00,01,
01,00,11,00,00,00,00,00,12,00,01,
01,07,00,00,00,00,00,00,00,07,01,
05,06,06,06,06,06,06,06,06,06,04,